%%%%%%%%%%%%%%%%%%%%%%%%%%%%%%%%%%%%
%%%% %% %%     %%  %%       %     P%
%  %%   % %%  %%  %%% % % %   %    %
%    % %% %% %%  %   % %    %   % %%
%    %  % %    %   %%%%%%%%%%%%%  %%
%   % %%  %%  % %%  %   %   %    %%%
%%       % %   % %    %%%   %% %   %
%    %%   %  %  % %% %  %%%      %%%
%  %%% % %%% %%% %%   %   % % %% % %
%% %%  %%%%  % %   %%%%  %    %%%  %
%%%               %%%    % %%%     %
%%%    %% % % %  % % %%%%   %%    %%
%%%    %% %%%  %  %%       % % %%  %
%  % %  %% %% % %       %%%   %  % %
% % % % %    %%% %    % %% % %     %
%       % %   %  %%        %     %%%
%%%% %   %%%     %% %     % % %    %
%   %%  %        % %%     %% %%%   %
%  %% %    %% %%  %%  %%%%     %   %
% %  %  %%   %% %% %% %  % % %%%   %
%    %      % %% % %    %   %%  %% %
%  %%%%% %           % %%  %%%%   %%
%%%%  %%% %%%%  %%%%  %% % % %     %
% % %  %%    %   % %  %% %% % % %% %
% %%  % %  % %% %%%     % %  %%%%%%%
%%         %%%  %   %  %    %    % %
% %   %%  % %  % %% %%%%%% %% % %  %
%        %%   %     %    %%%%%%    %
%   %%% %  % % % %    % %%   %%    %
%%  %    %   %% %%% %  %       % %%%
%  %    %  %%  %    %  %% %   % %% %
%   %% %%%       % %% % %%  % %%%% %
%   %%  %   % %% %%% %%  % %% %%  %%
%                 %%%%  %     %%% %%
%. % %%% %%          %% %%  % %%   %
%%%%%%%%%%%%%%%%%%%%%%%%%%%%%%%%%%%%
