%%%%%%%%%%%%%%%%%%%%%%%%%%%%%%%%%%%%
%% %%%    % %  %%   %  %       %% P%
%   % %% %  %%  % %   %  %%  %%%%  %
% %   %%  %     %%%  %%%      %%   %
%   %% %    % %     %   %    % %%% %
%     %  %%% %%% %% %     %% %   % %
%  % %    %%% % %  %%%% %    %     %
%  % %      % %%%%     %  %%%   %% %
%%%%%%   % %  % % % %   %  % %  %% %
%%    %%  %%%  %      % % %%%    %%%
% % %%   %%%%%%% %%  % %%   %%%  % %
% % %      %  % % %%  %  %  %  %  %%
%  %    % %%%    %     %  % % %   %%
% %   % %%%      %% % %%   %%%     %
% %    % % %  %        %  % %     %%
%%%% % %  %     %%  % %    %%%%%  %%
% %  %%% %    %% %%%% %        %%  %
%%% %    %     % %  % %%  % %% %%  %
% %%  %%       %%    %   % %    %  %
%% %%% %% %%   %   %   %%%         %
%% % %  %%%   %%   % %%%  %    % %%%
%   %  % %     %%  % %% % %% %  % %%
% %   %  %  % %%     %%  %%% %   %%%
%%%%      %%   %%  %        %  %% %%
%%      %   %      %  %% %%%% %  %%%
%  %  %%  % %  % % %  %%      % %% %
% %%% %   %   %%   %  % %%  %%  %%%%
% %          %%     %    %%%%%%% %%%
% %%% %% %  %% %%%% %%%%%    % %   %
%    % %%  %% %  %% % %     %%%%   %
%% %  %%    %% %  %    % %%   %   %%
% %%% %% %  %     %%   %   %   %% %%
% %     %   % %%%%   % %  % %%%%   %
%     %%%%  % %%%    %    % %  % % %
%. %%   %  %  %  %         % %%%%  %
%%%%%%%%%%%%%%%%%%%%%%%%%%%%%%%%%%%%
