%%%%%%%%%%%%%%%%%%%%%%%%%%%%%%%%%%%%
%    %%%%  %%    %%       %%% %%%%P%
%%% %    %  %   %%  %       %      %
% % % %%%%  %% %%%% %%%      % %  %%
%%  %% %% %       %%    %         %%
% %      %% % % %% % %  %%% %% % % %
%% %   %       %  %  % %% %   % %  %
%     % %%    %  %% %  %%%     % % %
%%%  %%     %% % % %% % %% %%%%% %%%
%%%%   %  %    % %    %    %  %   %%
%    %% %      %      %  % %  % %  %
%% %% % %  %%    %%% %  %%%   % %  %
% % %%%%%%% % %%  %%%  %      %    %
%  %%  %     %  % %   % % % %    % %
% %% %%%   % %  %  %  % % %%  %%   %
%     %%  % %% %     %  % %%%%    %%
%% %  %  %% % %%%%  %%   %%       %%
% %  %%%%%% %%    % %   % %  %%    %
%  %% % %       %   %% %       %%% %
% %%%%%   %    %%    %  %%%% %   % %
%    %%   %  % %%%% % %%  %        %
%% %%% % % % %        % %     % %%%%
%  %%  %%     %   %% %   % % %%    %
%% %   %%%    %  % %%% %%%    %   %%
%  % %%  %% %%%  %%%  %% % %%%%%%%%%
% % % %%   %%    %%  %    % %%   %%%
% % %%  %       %   % % %%  %%    %%
%%%   %          % %%  %      %%%  %
%%   %% % %%        % %    % % %   %
%%%     %%  %     % % % %   %%%  % %
%%  % %      %%  %  %%  %   %%     %
%   %   %   %  %% %%     %         %
%  %%%  % %%%% %    %    %  %%%% %%%
% %      % % % % %   %% %%  %     %%
%. %%%%%%% % %     %   %%  %   %   %
%%%%%%%%%%%%%%%%%%%%%%%%%%%%%%%%%%%%
