%%%%%%%%%%%%%%%%%%%%%%%%%%%%%%%%%%%%
%        %         %              P%
%%%      % %%%  %    %%       %   %%
%   %% %    % %  %%  %%    % % %% %%
%%% % %% %%%%  %  %%  %     %%  %  %
%  % % %%%%% %  %% %%   %% %%%  %% %
%%  %   %   %     % %%% %%%  %%%   %
%%%%%     %  %       %%     %%   % %
%   %      % %  % % %   %% %%    %%%
%       %     %%% %%%  %%    %  % %%
% %% %%%%  % % %    % %  %    %  %%%
%%%% %     %        %  %    %  %%%%%
%%%% %%    %   %% % % % %% %%%  %  %
%     %   %%      %%  % % %  % % %%%
% %% %  %%   %%  %%    %%    % % %%%
%   %  %    % %     %% %   %% %   %%
% % %%    %  %  %  % %  %        %%%
% %   %  %%%%% %%%  %   %%   %  %% %
% % %% %  %%   %%%%     %% %      %%
%%  %  %  %  % %%     %  % %%%%   %%
%  % %      %%  %   %%%%         % %
%  %  %  %% %  %   %  %  %%  %  % %%
% % %        %%   %  %%%    %  %%% %
%   %  %%        %  %%%    % %%%   %
%  %       %%%  %          %   %  %%
% % %  % %      %%  %%%%%  %%     %%
% % %  %%       %  %% %%%%% %%     %
%  %%% %          % %% %  % %   %% %
%   %% %%   %  %% %  %    %%  %%%%%%
%  % % %   % %%     %       %%%   %%
% %% %  %  % % %% %%   %    %  %%%%%
%     %  %  % %%%    % %   %%     %%
% %%%%  % %  %    %%% %   %   % % %%
%      % %%     %%%  %  % %%     %%%
%. % %  %     % %%%     % %%  %  % %
%%%%%%%%%%%%%%%%%%%%%%%%%%%%%%%%%%%%
