%%%%%%%%%%%%%%%%%%%%%%%%%%%%%%%%%%%%
%  %%        % %%%% % %% % %   % %P%
%  %% %%    %    %   %  %  %% % %  %
% %   %  %     %%%%     %        % %
%%%  %% % %  %%%  % % %   %  %  %  %
% %      %% %     %  %% %%  % % %  %
%    %%%  % %%%     % %   %%       %
% %  %   %%          %% % %     %%%%
%%  %%% %%    %%        %%%%     %%%
% %    % %%  %%%     % %    %%  % %%
%  %% %%%  %%%%%  %  %    %  %%   %%
% %%%  %  %  %  %%% %  %% %%%% %%% %
% %  %  %  %% %%%%%  %  %    % %   %
%   %%  %  % % %%    %   %   %  % %%
% %%%  %  %   %%%   %% %% % % % %%%%
%        %%%%%       %    %    %  %%
%%%%       %  % %       % %   %    %
% %%   %%  % %   %%%  %            %
%%    %%   %% % %  %   %%%   %%   %%
%  %   %       % %%   %  % % %%    %
% %%%%% %    % % %         %   %   %
%   %% %% %   %% % %% %%% % %%  % %%
% % %   % % % %   % % %      %% %% %
%% % %%%%   %  %  %%%%        %    %
% %  %% % %   %%%%      %   %  %% %%
%  %%    %  %   %%%  %%     %    % %
%%   %%  %% %%   % %%  %%   % %%   %
%  %% % %%%%      % %      %    %% %
%% %%  %  %     %% %% %   %%%   % %%
%           %%% %      % % %   %   %
%%  % %%% % % % %%     %   % % %  %%
%%  %% %  %   %     %%     %   % % %
%% %     % %   %%% %%%%%  % %%% %  %
%     % %% %%% %%  %  %%   %   %   %
%. %    %%   %         % %%   %%%  %
%%%%%%%%%%%%%%%%%%%%%%%%%%%%%%%%%%%%
