%%%%%%%%%%%%%%%%%%%%%%%%%%%%%%%%%%%%
%%  %  %%%% %%% %%  %    %   % % %P%
%    % %  %  %%   %  % % % %   %%  %
%  %   %% % %  %%% %% % %% %  %%% %%
%  % %     %   %   %%% % % %    %  %
% % %  % % %% % %   %   %%%  %   % %
%%       %  %%%   % %   %% %    %  %
% % %    %%%%   %% %%%%%    %  %  %%
%% %    %%%  %  %   %%% %% %%% % % %
% %%     %%  %  %  %%  %  % %  %  %%
%   % % %  %%  %  %%  %    %%  %  %%
%  %      %  %    %      %       % %
%  % %  %%%% %      %%%%  % % %%%  %
%% %%   %% %     % %  %    %       %
%% %      %     %%% %%%  %%% % %%% %
% % %   %  %  %%%   %%%%%%    %    %
%% %   %%%%  %%%%    %        %%   %
%%      %%    %   %  % %   %%%  %% %
%  %  %% % %  %%% %          %   %%%
%   %%% %  %%       %%% % %  %   %%%
%   %%%%%%%%  %         % %%  % %  %
%% %           %     %%  %% %%   %%%
%%%%     %%  %  % %%%%%%  %%%  %%%%%
%   %% % %%% %%  % %  %%%    %%% % %
%%  %%%% %   % %% %%   %    %  %   %
%% % %  %%     %  %%   %%          %
%% %%      %%      %   %   %%%%  % %
%% %    % %       %   %% %%    %   %
%%       %% %   %   %%  %  %% % %% %
%  % %    %  % %%    %%%      % %  %
% %%%%%   %  %  %%%%  % %  %   %%  %
%    %% %  %%%    % %         %    %
%%   %  %%    %% %% %    %%%%% %   %
%% %  % %      %    %%%%%% %       %
%.  %  %       %              % %% %
%%%%%%%%%%%%%%%%%%%%%%%%%%%%%%%%%%%%
