%%%%%%%%%%%%%%%%%%%%%%%%%%%%%%%%%%%%
% %%%  %%%    %  % %%  % %  %%%  %P%
%     % %   % %% %   %%%%    % %   %
%% % % %%      % %       %  %% %  %%
%  %% %       % %      %%  %  %    %
% %  %%% %  % %%%%%%   % % %%%   % %
% % % %   %  %    %%%  % %% %  % %%%
%%   %%% %     %   %%% %%%%%%%    %%
%   % %   %    %%       %%%  %   % %
%  %% %   %  % %   % %  %%    %  %%%
%%%%% %      %%%%   % %% % %%%     %
%%  %  %%  %   %  %   %% %%%%     %%
%    %%%  % %     %%       %  % %  %
%  % %%%   %  %    % %%      %%%% %%
%%%% %               %   %%% % %%  %
%  %   %%% %   %%     %  % % %     %
%        %% % %% %% %%%% %   % % % %
%     %    %     %% %  %% %%%% %%% %
% %%%  %  %%% %%%    %%%  % % %    %
%  %%%  % %  % % %   %  %   % %    %
% %     %   %%% % %%%%% %% %% %    %
%%   % %%             %%  %   %   %%
%%%  %%% % %%  %%  %%%%%  %  %%  %%%
% %  %%%%     % %% %    %%%%  % %  %
%%   % %%   %     %  % % % %  %%  %%
%%%%   %%%%% %%% % %%%   %%%  %  % %
% %%%%    %%%       %% % %    %  % %
%     %  %  %%  %  %  %  %%%%%    %%
%% % %% %%   %     % %  % %    % % %
% %%        %  %   %%%%%   %%     %%
%      %%%  %    %%    % %%%  %   %%
%%      %%%     %    %%%%  %   %% %%
%   %  %%%  %% %%   %      %  %    %
%%% %  %  % %%     %    %%         %
%.   %   %  %%%%%  %    %  %% %%  %%
%%%%%%%%%%%%%%%%%%%%%%%%%%%%%%%%%%%%
