%%%%%%%%%%%%%%%%%%%%%%%%%%%%%%%%%%%%
%% %%%      %%    %%%  %   %%%    P%
%     % %    %%  % %      %%    %%%%
% %    %%   %% % %   %%%%  % %   %%%
%%%%   % %  %%%%% %  % % % %%%    %%
%%   %%% %%       %%  % %%         %
%%  %%  %%   %%%%  %  %         % %%
%  %  %   %  % %%   % % %%     % %%%
%   % %   % %%%   % % % %% %%  %  %%
% %%  % %%     % %%     %%%    % % %
%             %     % %% %      % %%
%%%% %%% %%  %%%  %  %% %        % %
%%     %%%      %% %  %%%    %    %%
%%%  %%  %   %%   % %%            %%
% %%  % % % %     % % % % %%%% %  %%
%   %%      %%    %  %     %     %%%
% %  %%% %  % %%% %  %  %%      %% %
%%   % %    %    %            % %%%%
%%% %  %%% %   % %%   %%%%  % %  % %
% %%%   %  %%%%%% %%% %%%% % %     %
%%%   %%% % %%%%%   %%  %% %  %% % %
% %%%%    % %%  %% %  %%% %   %  % %
%   %%%% %   %% %%% % %% %%%%      %
% %%  %%   %  %%% % %   %   %    %%%
%% %%% %   %  % %  % %%  %  % % % %%
% %%  %      % %% %  % % %  %  %% %%
% %      % %  %%  %      %% % % %% %
%       %% % %    % %    %  %%     %
%  %% %%  %%%%          % %     %% %
% % % %    %%  %%    %%   % %%%  %%%
% % %   %    %%%  %%      %%%      %
%    %        %        %  %%%  %  %%
%%   % %% % %   %%% %%    %  %%  % %
%  %%     %%%   %     %  %      % %%
%.%%%%%  % %% %  %%%   %% %        %
%%%%%%%%%%%%%%%%%%%%%%%%%%%%%%%%%%%%
