%%%%%%%%%%%%%%%%%%%%%%%%%%%%%%%%%%%%
%  %%% % %%%%%%  %    %  %% % %   P%
% %    %% %% %       % %%% %      %%
%   % % %%%   %%%    %     %    %  %
%% %    %     % % %   % %%%  %  %  %
%  %    %% %  %  %%%  % % %   %  %%%
%% %   % %%%%% %%%  %%%% %  %%% %  %
%%     %             %   % %    %  %
%     %  % % %          %%  %%   %%%
% %       %%        %   %  %%%    %%
%%%      %% %   %     % %  %     % %
%   % %   %  %%  %   %%   %%   %%  %
% %    %   %% %%  %%% %    %     %%%
%%  %% % %% %%%     % %% %% %%% %  %
%    %     %  %% %   % % % % %  %%%%
% %     %%%%   % %   %  %%%    %   %
%%% %% % %%  % %  %%  %            %
%%%%         %%%% %   %   %% % % %%%
%  %% %%%   %   %   %     % %%     %
%%% %    % %%% %   %  %%%%  %% % % %
% %%  %% %     %%%    %     %  % % %
%     %  %%    %%  % % %  %   %%  %%
%   % % %% %%  %%    %% %   %    % %
%            %  %% %%    %%%%%%% % %
%     % %  %  %    %%  %   % %%% % %
% %  % % %%%%  %%     %    %  %%  %%
%%%        %%%    %%%  %    %% %% %%
%%% % %         % %     %   %% %%  %
%% %% %    %  %  %    %% % %% %% %%%
%  %   %   %% %%%%% %%%        %% %%
% % %    %   %    %%    %%  %    % %
%  % % %%%% %     % %%%%   %  %  % %
%      %   %    % %  % %% %   %%%% %
%   %% %% % % %  %  % % %%%%%%     %
%. %%   %   %   %       %%  %% %   %
%%%%%%%%%%%%%%%%%%%%%%%%%%%%%%%%%%%%
