%%%%%%%%%%%%%%%%%%%%%%%%%%%%%%%%%%%%
%  %%%  %    %     %% % %      %% P%
%  %%% %   %   %%   %   %   %%%%   %
% %   % %  %% % %%%  % %  % %% %%% %
%%%    %%   % %   % %%     %  %    %
% %   %    %%  %  % %     %%   %   %
%%   %   %    %%  % % %%   % %   %%%
%%% %   %%%%% %   % %  % %%      %%%
%%%%%  %%  %%  %%%   %  %%% % %    %
% %       % %          %   %    %  %
%% %             %   %      %  %%  %
%%% %  % %   %% % % %% %   %  %    %
%%   % % %  %% %%%   %% % % %      %
%%% %%   %    %    %     %%    %   %
% %   %%  %  %%%   %% %%%  %%   %% %
%%%      %% %% %   %  % %  %   %   %
%%%%   %%%        %% %%%% %% %% %  %
%% %   %  %%  %%% % %%   %  %%% %% %
%%  % %  %      %   %%      % %% % %
%  %% %  %%% %% % %    %   %% %    %
%     %     %%% % %   %   % %% %%  %
%    %%     % %   %%% %%   %     % %
%  %    %%%     %    %%      %   % %
%%    %% % %  %%    %% %    %%  %  %
% %  % % %   %%      %  %%     %   %
%%   %%%   %%%%   % %  %      %% % %
%% %% % %%%%  %%% % %%%%%    % %%  %
%%      % %    %    %%   % %   %%  %
% % %%    %  % %%   %%%  % %%      %
%%   % %    %      %   % % %  %%%% %
%%   %  % %     % %%%   %  %     %%%
%%%%%% %%    %  %  %% %%  %   %    %
%    % %  %  %  %%       %%      %%%
%    %% %% %  %%%%%%    %   %  %   %
%.            %  %  %     %%  %% % %
%%%%%%%%%%%%%%%%%%%%%%%%%%%%%%%%%%%%
