%%%%%%%%%%%%%%%%%%%%%%%%%%%%%%%%%%%%
%% %    %%% %%  %      %  %% %    P%
%%% %%  % %  %%% %%%  % %%%  %%%   %
%    %%%     %      %   %%% % %   %%
%       %  % %   %%     %  %%%%    %
% %%    % %%%       %% % %    %% % %
% %%   %   %    %  % % %     %%%  %%
% %         %% %  %    %%% %      %%
% %   %% %%    %  %         %   % %%
% %   %  %   % %%  %%     %%  % %  %
%  %  %%    %%        %%       %   %
% %%   % %%%%     %%%  %  % %%% %% %
% %    % % %    % % %%  %%%  %%    %
% %% %  %%   % %     % % %%% % %  %%
% % %   %%   %% %%%    %%  %    %% %
% %%%         %%  %  %       %    %%
% %   %%% % %         %%  %    %   %
%  % %%    %%%%  %% %%% %%%%       %
%%  % % % % %    % %     % %      %%
%% %  %     %   %% %    %%% %% % % %
%    %  %  % %   % %         %%% %%%
% %%%   %% %    % %%%  %  %  %  %  %
%   % %    %%         % % % %% %   %
% %%% %%  % %% % %  %%% %%%      % %
%   %%%  % % %     % %%%  %  %  %% %
%%  %  % % %%% %  %  %% %  %  % %  %
% %  %%%    %%%%%   %%   % %%% %%% %
% %       %  %%%%% %%  %  %%    %  %
%    % % %  %%% %%%  %   %%   % %  %
%  %%   %% %%      % %% %  %%    %%%
%%% %   %  %    % %%  % %%%     %% %
% % %   %  % %%   % %      %%  %%% %
%% %%       % % %%           % %% %%
%     %  % %% %  %    %%     % % %%%
%.% % %%%% % %%%       %%% %  %%%% %
%%%%%%%%%%%%%%%%%%%%%%%%%%%%%%%%%%%%
