%%%%%%%%%%%%%%%%%%%%%%%%%%%%%%%%%%%%
%  % % % %%%%             %%    % P%
%   %%        %%  % %%     %    % %%
%  %%    %%    % % %% %%  %%%%  % %%
%%% %     %% %%    %% %%      % %  %
%% %    %    %     %%%   %         %
%%% %%%  %%%  %    %%%%% %% %   %% %
%%%%%     %%  %    %  % %       %%%%
%  % % % %     % %%   %%  %  % %%%%%
%%%%   %%        % %  % %%  %  %%  %
%   %% %% % %%  %    %   %%%%%%%% %%
%% %%  % %%  %    %%%  % %  %%     %
% %%   % %         % % % % %       %
%%  % %     %   %    % %  %   %%%  %
%   % %  % % % %%      % %%  %   %%%
%%% % %  %    %       %%%   %%     %
%% %     % %% % %%   %%%       %% %%
% %  % %  %%  %   %   %%%%% %% %% %%
%%         %   %  % %   %  %%%%%%%%%
%   %%% %  %     % %%   % % %%   %%%
%%%%    %%%%  %        %  % %   % %%
%%       %     %    %  %%%   %%    %
%     %   % % %%%%   %% %  %  %    %
% % %     % %% %%%%  %% %%      %%%%
%  %     %  %  % %%%%% % %    %%%  %
%   %%%%% %   %       % %   %  %  %%
% %   %%      % %   %%%   % %    % %
%  %%  %%%    %%    % %  %%%% %   %%
%   %%%% %  %  %  %%  % %   %%%%   %
%%% %%%   %  %%   % %     %% %% %  %
%%%   %  %% %%        %%  % %% %  %%
%% %   %%%  %%   % %  %     %%  %  %
% %         % % %%%   % % %   %    %
%   %  %%%%      %%%%%%  %%  %  %  %
%. % %%     %% %  %   %  %%% % %   %
%%%%%%%%%%%%%%%%%%%%%%%%%%%%%%%%%%%%
