%%%%%%%%%%%%%%%%%%%%%%%%%%%%%%%%%%%%
%%   % %   %         %  %%% %     P%
%%%%%% %  %%%%  %    % %  %%  %  % %
%% %%% %  %% %  %%%  %%% %  %  % % %
%% % %  % %  %%    %% %   % %  %%  %
%  %%  %%    %%  %% %  % %   %%%  %%
% %    %%     %  %%%%%  % % % %  %%%
% %% % %% %%%%%     %     % %%% %  %
%      % % %%    %    %%  %        %
% %   %     % % %    %%%%  %   %   %
%   %   %% % %     % % %%     % % %%
%% %% %%  % %%   %%   % %%%   %%   %
% %   %%%    %      % %   %  %  % %%
%%      %%% %  %%  %% %           %%
%%%%%%  % % % % %%    %  %%  % %  %%
%%   % % % %  %   %      %%  %%    %
% %% % %  % %%%   %     %%%%%   %% %
% %        % %     %% %% %% %  %%% %
%     %%     %%% %         %  %  % %
%% %  %      %  %%%% %   % % %%%   %
%% %%%    % %%% % %         % %  % %
%  %  % %  %  %%% %%       % % %   %
%% %  % %  %%%   %       %   %  %  %
% %% % %        %  %  %%  % %%%  %%%
%%%%  %%%    %  %%%%   %%  %       %
%% %%%%%       %  %  %  %  % %     %
%         % %     % %  % % %% %    %
%   %% %% %%   % %%  %  %% % % %% %%
%% %  % %    %%%   %       %%    % %
%  % % %    %       %  %%%%%%% %%%%%
%    %  %%  % %%%%  %%  %  %% %% %%%
% % %  %      % %%   %     % % % % %
% %% %    %% % %% %%  %%   %   % %%%
%    % %%% % %%   % %    % %% %  % %
%.%    %%% %   %% %% %%  %      %  %
%%%%%%%%%%%%%%%%%%%%%%%%%%%%%%%%%%%%
