%%%%%%%%%%%%%%%%%%%%%%%%%%%
% %   % %   %        %%%%P%
% %%   % %    % %   %%%%  %
%% %  % %%       %  %  %  %
%%%   %  %%% %%%     %%  %%
%       %  %      % %%  %%%
%%    %  %%%% % %    %  %%%
%%%%% % % %   %      %%   %
%    %  %%% % % %%  %     %
%  % %% %    %% %%%  %    %
% %%   %%%    %    %      %
% %% % %  %   %%   %%%   %%
%  %%       %   %%     %  %
%%  % %%%% % %   %%   %% %%
%  % % %% % %   % % %  % %%
%%  %%%  % % %%%   % % % %%
%. %   %       %  %  %%  %%
%%%%%%%%%%%%%%%%%%%%%%%%%%%
