%%%%%%%%%%%%%%%%%%%%%%%%%%%
%% %  %  %  % %  %%%  %% P%
%%%%%%    %  % %    %  %  %
%% %  %% %%%   % %%     % %
%%%%  % %%% %%%  %%%% %   %
%%      % %%         % % %%
%     %%%  %% %% % %   %  %
% %  %%  % %  %   %%  %   %
%      %      %      %%   %
%%  %    %%%   % % % %%   %
%  % %%%    %   %   %% % %%
%   %   %% %   %%    %   %%
% %%%%% %%  %%%     %     %
% %  % % %%  %%  % %% %   %
%   %%%   %%    %  %   %% %
%%% % %      %   % %   %% %
%.  %  %%%%  %   %%  %    %
%%%%%%%%%%%%%%%%%%%%%%%%%%%
