%%%%%%%%%%%%%%%%%%%%%%%%%%%
%%%%%   % %%%% %  %% %   P%
% %% %  % %  %    % % %  %%
%%%%%%  %    % % %%% %% %%%
%    %        %  %%   %  %%
%          %% %%% % %%  % %
%   %  %  %% % % %%%% %  %%
%%      %   %%    %       %
%  %%  %%% %%%        % %%%
%  %  %%%      % % %    %%%
%%    %  %%   %    %% %   %
% %% % %%  %  %%%% %   %  %
%%    %  % %   %  %    % %%
% %  %  %% %        % %%% %
%    %% %  % %%%%%%%  %  %%
%  %  %%  %%  %    %      %
%.  %   %%%      %    %   %
%%%%%%%%%%%%%%%%%%%%%%%%%%%
