%%%%%%%%%%%%%%%%%%%%%%%%%%%
%    %% %% %  %%%    %%%%P%
%   %  %     %%   %  %%   %
% %           %      %  % %
% % %%   %            %  %%
%     %% % %       % %    %
%%      % %%%%         %  %
%   %%    %    %     %%%  %
%% %    %  %%  %  %%%  %% %
%        % %% %%    %%   %%
% % %%  %%%  % %%%%%   %  %
%% %       % % %      %   %
%%   %   % % %%   %     % %
% %%%% % %        %       %
%%%         %  %  % % %%%%%
%   % %   %%% %      % %% %
%.% % %%   %  %  %%  %  % %
%%%%%%%%%%%%%%%%%%%%%%%%%%%
