%%%%%%%%%%%%%%%%%%%%%%%%%%%
%%%    %     %    %%%  % P%
% %  %   %% % %    %   % %%
%   %     %  %  %     %%  %
%    %%% %        % %    %%
% %%%  %% %%     %  %% %  %
%  %%%  %       %%%%% %% %%
% %       % % %%%%%% %   %%
%  %% %%%%%%  %%   %%  %  %
%%   %%     %  %    % %   %
% % %%%%  % %%%  %   %%%% %
% %        % %%%  %   %%  %
%   %%  % %      %% % %%  %
%  %%       %% %%%  % %   %
% %% %% %%  %  %% %%%%  % %
%    %%  %      %%%   %  %%
%.%% %  %%%% %       %% %%%
%%%%%%%%%%%%%%%%%%%%%%%%%%%
