%%%%%%%%%%%%%%%%%%%%%%%%%%%
%%             %%%%   % %P%
%     %% %%%%       %  %  %
%  %   %   %%   %     %%% %
%  %  %   %  %%   % %     %
% % %   %%%%  % %%%%%%% % %
%   %%%      %% % %  %%%%%%
%  %%  %   %  % %%    %%  %
% %  % %  %%%   %  %%%%   %
%  %%% %      %%     % %%%%
%   % % %%      %   %  %  %
% %   % %%   % %  %%% % % %
% %%% %%  %   %%%    %    %
% %   %    %  % %   %    %%
%%% %    %% %%% %       % %
%   % %%          %  %    %
%.  % %    %   %  %%    %%%
%%%%%%%%%%%%%%%%%%%%%%%%%%%
