%%%%%%%%%%%%%%%%%%%%%%%%%%%
%  %%   % % % %   %%     P%
%%     %   % %% %%%  %  %%%
%%%%  %%     % %   %  %   %
%% % %%%% %% %%  %%% %    %
%%% %     %   %%   % % %% %
%%%          %  %%% %  % %%
%%%    % %% %% %%  % %   %%
%% % %   %%  %  %%        %
%   %%%    % %    %  %%   %
%   %  %   %          % % %
%  %% %%%% % %%%    %%% % %
%  %        % %  %%%%  %  %
%%      % %    %% % %%  % %
%     %    % % % %%   % % %
% %     %   %             %
%.%      %% %%     %     %%
%%%%%%%%%%%%%%%%%%%%%%%%%%%
