%%%%%%%%%%%%%%%%%%%%%%%%%%%
%   %  %% %%%     %  %   P%
%   %   %%  %%     %   % %%
%     %  % %   % %%  % % %%
%%% % %% % % %%%%%%%%    %%
%   %   %%%   %% % %  % % %
% %%  %   %% %       %%  %%
%  % %%   %        %%% % %%
% %    %     %     %    % %
%  %     % % %%% %% %   %%%
%  %  % %    %%    %      %
%  %  %%  %% % % %%%%   % %
%% %    %  %%%  % %     % %
%  %  %    %  %%%%  %    %%
% %  %   %      %%%  %%   %
% %    % %  % %  %   %%%  %
%. % %%%%%      %%%   %% %%
%%%%%%%%%%%%%%%%%%%%%%%%%%%
