%%%%%%%%%%%%%%%%%%%%%%%%%%%
%  %  %      %%     %%% %P%
% %%  %% %  %% %% % %     %
%          %       %%% %  %
%%   %     %%     %% %% % %
%%%%% %% % %     % %   %% %
% %%  %   %%% %% % %% %%  %
%      %%% %  %%  % % %   %
% %     %% %% % %%%  %  % %
% %% %    % %  %   % %%%  %
% %   %%    %%%%%   %% % %%
%  %   % % %   %%% %     %%
%% % %%   %%   %      %%  %
%   %%   %  %  %   %%  % %%
%    %%  %%      % %    % %
% % %%      %%%%       %%%%
%. %%%    %     %  %%%%% %%
%%%%%%%%%%%%%%%%%%%%%%%%%%%
