%%%%%%%%%%%%%%%%%%%%%%%%%%%
%  %% % %%%    % %   %%  P%
% % %%  % %  %%  %%% %% %%%
%%%   % %%%  %   %%  %  % %
%%%%  %       %% %%      %%
%   %    % %%%  % %   %   %
%    %%  %   %%     % %%  %
% %%%%%    %% % %%%       %
%   %      % % %%   %   % %
%%     % %   % %%   %% %% %
%% %  %%        % %  %%% %%
%  % %  %      %% %%% %   %
% %%%%% %%   %  % %   %%%%%
% %   %           %  %    %
%  %%%%%  %% % %   %%  %  %
%%    %%%%   %%% % % %    %
%. % % %%%   % %%  %% % % %
%%%%%%%%%%%%%%%%%%%%%%%%%%%
