%%%%%%%%%%%%%%%%%%%%%%%%%%%
% %%           % %%%%    P%
%%  %  %%%   %   % %      %
%    %%  % %%%  %     % % %
% %%%%%   %  %%% % %% %   %
% %  %  %      %    %%%   %
%%     %%%% % %   % % %% %%
%  %      %        %%     %
%  %  %   %% % %    %%% %%%
%%%% %   %%%%% %  %  %    %
%%  %%%  %%   % %     %   %
%  %% %      %% % %       %
%%%           %%%  %% %   %
%   %% % % % % % %%%%  %  %
%   %    %%    %%  %  % %%%
%%    %  %%  %% %%%%%%  % %
%.   %  %%    %%% %%% %  %%
%%%%%%%%%%%%%%%%%%%%%%%%%%%
