%%%%%%%%%%%%%%%%%%%%%%%%%%%%%%%%%%%%%%
%       % % %           %   %     % %%
% %%%%%%% % %%% % %%% %%% %%%%%%% % %%
%       %       % %     %     % %   %%
%%%%% %%%%% %%% % % % %%% %%%%% % %%%%
%   % % % %   % % % %   % %   % %   %%
% %%% % % % %%% %%%%% %%% % %%% %%% %%
%       %     %   %   %     % % %   %%
%%% %%%%%%%%% %%%%%%% %%% %%% % % % %%
%             %       % %   %     % %%
% % %%%%% % %%% % % %%% % %%% %%% % %%
% % %     % % % % %     %   % % % % %%
% % % %%%%%%% % %%%%%%%%% %%% % %%% %%
% % % %     %   %     %     %   %   %%
%%% %%% % %%%%% %%%%% %%% %%% %%%%% %%
%     % % %     % %     % %   % % % %%
% % % % % %%% %%% %%% %%% % % % % % %%
% % % % %                 % % %     %%
%%% %%%%%%% % % %%%%% %%% % %%% %%%%%%
%       % % % %     %   %     % %   %%
%%%%% % % %%%%%%%%% %%%%%%%%%%% % %%%%
%   % %           % %     %   % %   %%
% %%% %%%%% %%%%%%%%% %%%%% % % %%% %%
% %   %      %        %     %       %%
% % % %%%%% %%% % % % % %%%%%%%%%%%%%%
% % %   %     % % % %       %   % % %%
% % %%% %%% % % % %%%%%%%%% %%% % % %%
% %   % %   % % %   % %   % % %     %%
% %%% %%% %%%%% %%% % % %%%%% % %%%%%%
%       %   %     % %     %   % %   %%
%%% % %%%%% %%%%% %%% %%% % %%% % %%%%
% % % % % % % %     % %   % %   % % %%
% % %%% % % % % %%%%%%%%% % % % % % %%
%   %   %   %                 %     %%
% % % % %%% %%% %%%%%%% %%% %%% %%% %%
%.% % %P       %   %       %   % %  %%
%%%%%%%%%%%%%%%%%%%%%%%%%%%%%%%%%%%%%%