%%%%%%%%%%%%%%%%%%
%% %   % % % %  P%
%   % %%  %      %
%%%%       %     %
%  % % %  %%%%  %%
% %    % %   % % %
%%   % % % % %   %
%. %% %        % %
%%%%%%%%%%%%%%%%%%
