%%%%%%%%%%%%%%%%%%
%      %% % %%% P%
%  %%% %%   %%%% %
%  %% % %%     % %
%  %%  %%        %
% % %      %   %%%
%      %   %   %%%
%.%  %% % %%% %  %
%%%%%%%%%%%%%%%%%%
