%%%%%%%%%%%%%%%%%%
% %% %%%  %     P%
%    %  % %%   % %
% %%    %    % % %
%   % % % %%%%%% %
%    %%  %  % %% %
%   %%           %
%.   %  % %  %  %%
%%%%%%%%%%%%%%%%%%
