%%%%%%%%%%%%%%%%%%
%%%  %   %% %%% P%
%%     %    %  % %
%% %%   %     %  %
%  % %  % %   %% %
% %   %%%%% %  % %
%     %  %   % % %
%.   %%% % %%%   %
%%%%%%%%%%%%%%%%%%
