%%%%%%%%%%%%%%%%%%
%%%%%     %     P%
%%%%   % %  %% % %
%  %% %     % %% %
%       % % % %% %
%% %%    % %  %%%%
%%  %    % %%%   %
%. %  %% %%% %   %
%%%%%%%%%%%%%%%%%%
