%%%%%%%%%%%%%%%%%%
%%%%    %   %  %P%
%  %%   %% % % % %
%  %  % %% %     %
% % %% %   %%%   %
%%   %   %     % %
%  %     %% %    %
%.%%% %    %  %%%%
%%%%%%%%%%%%%%%%%%
