%%%%%%%%%
%% % %%P%
%% %  % %
%  %    %
%      %%
%   %% %%
%    %  %
%.%   %%%
%%%%%%%%%
