%%%%%%%%%
% %    P%
% %% %  %
%%    %%%
%% % %% %
%  %  % %
% % %  %%
%.    % %
%%%%%%%%%
