%%%%%%%%%
%%%  %%P%
%   % % %
%% %%%  %
%   %%% %
%       %
% %   %%%
%.% %%% %
%%%%%%%%%
