%%%%%%%%%
%%  %  P%
%  %    %
%%      %
%    %%%%
%  %%% %%
% %   % %
%.% % % %
%%%%%%%%%
