%%%%%%%%%
%%%%%% P%
%%%% %  %
%     % %
%  % %  %
% % %   %
%    % %%
%.%%    %
%%%%%%%%%
