%%%%%%%%%
%% %   P%
%       %
%%   % %%
%% % %  %
%%  %   %
%    %  %
%. %  % %
%%%%%%%%%
