%%%%%%%%%
%      P%
%  %%%% %
% %  %% %
%     % %
%   %%%%%
%%%  %  %
%.      %
%%%%%%%%%
