%%%%%%%%%
%      P%
%   %  %%
% %%%   %
% %% %%%%
%   %%% %
%%  % % %
%. % %% %
%%%%%%%%%
