%%%%%%%%%
%%% %  P%
% %%  %%%
%%% %   %
%  % % %%
%%  %% %%
%%      %
%. % %  %
%%%%%%%%%
