%%%%%%%%%
% %    P%
% %%  % %
%%%  % %%
%  % %%%%
%%    % %
%   % % %
%.%% %  %
%%%%%%%%%
