%%%%%%%%%
%% %%%%P%
%  %    %
%    %  %
%% %% %%%
%%    % %
%   %  %%
%.    %%%
%%%%%%%%%
